NO textures/wolfenstein/barrel.xpm
EA textures/wolfenstein/bluestone.xpm
WE textures/wolfenstein/barrel.xpm
SO textures/wolfenstein/eagle.xpm

F 5,100,255
C 3,138,89

1111111111111111111
111111111111111111111111111111111111
1111111111111111111111111111111111111111111111111
1111111111111111110000000E11111111111111111111111
1111111111111111110000000000000111111111111111
11111111111111111111111111111111111
