
NO textures/wolfenstein/colorstone.xpm
EA textures/wolfenstein/greenlight.xpm
SO textures/wolfenstein/grey_stone.xpm
WE textures/wolfenstein/wood.xpm

F 12,176,200
C             12,176,200

111111111111111111111111
100000000000000000000001
11111111111111111111S111
100000000000000000000011
111111111111111111111111111
