
























NO textures/wolfenstein/eagle.xpm




EA textures/wolfenstein/pillar.xpm


SO textures/wolfenstein/purple_stone.xpm


WE textures/wolfenstein/red_brick.xpm

F          -1,2,3
C     0,0,1

11111
100N1
11111

