
F            145,67,189
C                   255,200,100


NO textures/wolfenstein/eagle.xp

EA textures/wolfenstein/colorstone.xpm

WE textures/wolfenstein/bluestone.xpm

SO textures/wolfenstein/mossy.xpm


111111111111111111111111111
100 11111111111111111111111
1111111111111111111111111111111111111111111111111
10000000000000000000000W0000000000000000000000001
1111111111111111111111111111111111111111111111111
