F 167,255,0

C 123,165,2

NO textures/wolfenstein/mossy.xpm

EA textures/wolfenstein/barrel.xpm

SO textures/wolfenstein/eagle.xpm

WE textures/wolfenstein/greenlight.xpm

NO textures/wolfenstein/grey_stone.xpm


111111111111
1000000000N1
111111111111111111111111111111111111111111111111111111111111111111111111111111111111111111
