F 45,67,123

C                    98,281,012



NO                      textures/wolfenstein/mossy.xpm

EA textures/wolfenstein/pillar.xpm



SO       textures/wolfenstein/purple_stone.xpm

WE   textures/wolfenstein/eagle.xpm

C 123,67,21


111111111111111111111111111111111111111111111111111111
1111111111101111111111111111011111010000011111111111111
1010111
111111111111111
11111111110N111
1111111111111111111
