11111111111111111
10000000000000001
1111111111111S111
11111111111111111111111
