



F 145,67,189
C 123,10,100

NO textures/wolfenstein/mossy.xpm


EA textures/wolfenstein/hello.xpm

SO textures/wolfenstein/red_brick.xpm

WE textures/wolfenstein/wood.xpm

1111111111111111111111
10000000000000000000S1
1111111111111111111111
