
NO textures/wolfenstein/mossy.xpm
EA textures/wolfenstein/wood.xpm
SO textures/wolfenstein/colorstone.xpm
WE textures/wolfenstein/bluestone.xpm

C 123,15,188
F 90,2,14

111111111111111111
1000000000000111
10000000000S11
1111111111111
