NO textures/simonkraft/basalt_top.xpm

F 123,45,67


C 45,98,177

EA textures/simonkraft/mycelium_top.xpm

WE textures/simonkraft/warped_nylium.xpm

SO textures/simonkraft/wet_sponge.xpm

11111111111111111
11111111N11111111
11111111111111111

