NO textures/simonkraft/netherrack.xpm
EA textures/simonkraft/mossy_cobblestone1.xpm
SO textures/simonkraft/bookshelf_03.xpm
WE textures/simonkraft/soul_sand.xpm

F 72,111,56
C 78,159,229

11111111111111111111111111111
1111111111                  11111111111
11111111111111111111111111111111111111111
111110000000000000000000N11111111111111111111
111111111111011111111110111111111111111
1111111111110111111111111111111111111
1111111111110111111111111111111
111111000000000000000000111111111
100000000000000000000000000111111111111111
100000000000000000000000000000011111111111111
1111111111111110000000000000000000000111111111111111
111111111111111111100100100100100100111111
11111111111111111111111111111111111111
