NO textures/simonkraft/bookshelf_02.xpm
SO textures/simonkraft/basalt_top.xpm
EA textures/simonkraft/mossy_cobblestone1.xpm
WE textures/simonkraft/warped_planks.xpm

C 55,22,99
F 01,00,22

111111111111111111
110000000000000001111111111111111
1000111111111111111111110000001111
100000000000000000001111111111111111111111
10000000000000000000000000000000011111111111
11111111111111111111111E1111111111111111111111
111111111111111111111111111111111111111111111

