

































F 0,  9, 111

NO                             textures/wolfenstein/bluestone.xpm








C 55,255,         99


WE textures/wolfenstein/wood.xpm

           SO textures/wolfenstein/colorstone.xpm



EA textures/wolfenstein/grey_stone.xpm

11111111111111111111111111111111111111111
1                                       1
10000000000000000000000000000000000000001
111111111111111111111111111111111111111W1
11111111111111111111111111111111111111101
1111111111111111111111111111111111111110111111111111111111
111111111111111100000000000000000000000000000011111111
111111111111111111111111100000111111111111111111111101
1111111111111111111111111111101111111111111111111111111
111111111111111111111111111111
