NO textures/simonkraft/soul_soil.xpm
SO textures/simonkraft/cyan_concrete.xpm
EA textures/simonkraft/cobblestone.xpm
WE textures/simonkraft/warped_planks.xpm

F 89,76,3
C 124,233,5

1111111111111111111111
10000000000000000000011111111111
1000000000000000000000111111111111
1000000000000000000000E11111111111
111111111111111111111111111111111111111
