NO textures/wolfenstein/barrel.xpm
EA textures/wolfenstein/mossy.xpm
NO textures/wolfenstein/eagle.xpm
WE textures/wolfenstein/bluestone.xpm
SO textures/wolfenstein/wood.xpm

F 125,125,125
C 0,0,1


111111111
1000000N1
111111111
