F 45,18,29
C 23,99,6

111111111111
100000001
11111N111
111111111

NO textures/wolfenstein/eagle.xpm
EA textures/wolfenstein/red_brick.xpm
SO textures/wolfenstein/wood.xpm
WE textures/wolfenstein/greelight.xpm
