1111111111111111111111
10000000000S1111111
111111111111111111


C 145,16,12
F 123,126,7

NO textures/wolfenstein/barrel.xpm
EA textures/wolfenstein/bluestone.xpm
SO textures/wolfenstein/colorstone.xpm
EA textures/wolfenstein/greelight.xpm
