NO                  textures/wolfenstein/bluestone.xpm



EA textures/wofenstein/eagle.xpm


WE textures/wolfenstein/greenlight.xpm

SO textures/wolfenstein/mossy.xpm


F 128,128,128

11111111111111111111
111111
11111111111
1111111111111111
11111111111111111111111
111111111111111111111111111111111111111111111111111111111111111111111111
111111111111111111111111111111111111111111111111111111111111111111111111
111111111111111111111111111111111111111111111111111111111111111111111111
111111111111111111111111111111111111111111111111111111111111111111111111
111111111111111111111111111111111111111111111111111111111111111111111111
111111111111111111111111111111111111111111111111111111111111111111111111
111111111111111111111111111111111111111111111111111111111111111111111111
111111111111111111111111111111111111111111111111111111111111111111111111
111111111111111111111111111111111111111111111111111111111111111111111111
1000000000000000000000000000E0000000000000000000000000000000000000000001
111111111111111111111111111111111111111111111111111111111111111111111111
11111111111111
1111
11111111111111111111111111111
1111111111111
1111111111111111
