NO textures/wolfenstein/wood.xpm
EA textures/wolfenstein/barrel.xpm
SO textures/wolfenstein/colorstone.xpm

F 128,50,30
C 0,44,255

1111111111111111111111
1000000000000000000011
1000000000011111111111
1000000000011111111111
11111111N1111111111111
1111111111111111111111
